1111111111111111111
1000000000000001111
1001011111000001111
10010000C0000001111
100100000P000E01111
100011111C110000001
1111111111111111111