1111111111111111111
1000000000000001111
1001011111000001111
10010000C0000101111
10010000000C1E01111
10001111101101000P1
1111111111111111111