111111111111111111
111110000000000101
100000000000001001
100000000000010C01
10CPE0000000001001
111111111111111111