1111111111111111111
1000000000000001111
1001011111000001111
10010000C0000101111
1001000000001E01111
100011111C1101000P1
1111111111111111111